111111111111111
1P0CCC010CCC001
101101111101101
1CCCCCCCCCCCCC1
101101010101101
10CC0111110CC01
101001000100101
1010CC010CC0101
10CCCCCCCCCCCE1
111111111111111